Sounddisk 2 -The Best of Grubi- - Brainstorm
Scoopex Melodies - Scoopex
Sane Sound - Academy
ScrewBalls - Phenomena
SCR Musax 2 - Scrapers
Seeing is believing - Anarchy
Semi93 invitation - Manitou
Sensenmann - United Forces
Sequential - Andromeda
Seven seas - Andromeda
Seven Sins - Scoopex
Sexvens - Morelove
ShadowFire - Exact
Shed Tears - Ozone
Sigh - Old Bulls
Simpsons Demo - Decay
S - Skarla S
Smau 92 Music Disk - Nightfall
Snap! - Rebels
Soft Movie - Genocide
Software - World Federation of Mad Hackers
Songs of Infinity - Pointless
Sonical Fantasia - Equinox
Sonic Attack - Dual Crew & Shining
Smell Of Shit (S.O.S) - Melon Dezign
Sound and Vision - Rebels
Sound Atax Vol. 1 - Magnetic Fields
Sound Atax Vol. 2 - Magnetic Fields
Sound Atax Vol. 3 - Magnetic Fields
Sound Barrier - Balance
Soundbox 2 - Alpha Flight 1970,Genesis (Alpha Flight)
Sound De Light - Software Of Sweden
Sounddemo - Syndicate
Sound Disk - Zenith
Sound Disk 1 - Mygon
Sound Disk 2 - Mygon
Sounddisk - Possessed
Sound engine - Absence
Sound Engine 2 - Absence
Sound Erection - Shining 8
Sound Highlights 1 - Timex
Sound Mania 2 - Pussy
Sound of Music 7 - Cave
Sound of Silents - The Silents
Soundquest 1 - Quest
Sound Quest #2 - Quest
Soundrevolution 6 - Celtic
Sounds of Gnome - Mahoney & Kaktus,Northstar
Soundtracker Injury 2 - Electronic Artists
Soundtracker Injury 3 - Electronic Artists
Soundtrip - Shadows
Sound Vision - Reflect
Sozzled somersault - The Silents
Spaced Out Vol. 1 - Magnetic Fields
Spaced Out Vol. 2 - Magnetic Fields
Spaceship - Doctor Mabuse Orgasm Crackings
Spasmolytic - Spaceballs
Spellcheck - Andromeda
Sploosh - Anthrox
Spring Melodies - Anarchy
Stag 1 - BNK-Team
Stag 2 - The BNK Team
Stag 3 - BNK-Team
Stag 4 - BNK-Team
Stag 5 - BNK-Team
Stag 6 - BNK-Team
Stag EXTRA - BNK-Team
Stag 1 - BNK-Team
Stateline - Complex
State of the Art - Spaceballs
Static Chaos - The Silents
Status quo - Mad elks
Status quo - Mad elks Fast
Stereo Sounds - Eon
Steve Vizard Demo - Decay
Stop Fascism - Alcatraz,Interactive
Strange Dream #1 - Willow (Amiga)
Strange Music 2 - Strange
Strange Music 3 - Strange
Subliminal Vision - Bass
Substance - Quartex,Alliance design
Subtle shades - Nuance
Sunset glow - Thrust
Sweet music - Crusaders
Sweet Revenge - Decay
Sweltering Forest - Apocalypse Bay
Synthesis - Underground
Synthetic Power - Cave
Synthetic Vibes - Quartz
System violation - Anarchy