Can I Play With Madness ? - Defcon One
Capricorn One - Cydonia
Cebit'89 - Exact
Cebit demo 90 - Revenge of babbnaasen - Red Sector Inc.
Celebration - IT
Cerebral Delights - Goldfire
Checked implosion - Intryx
Cherokee - Manitou
Chip Attack - Anathema
Chip Music Festival - Magnetic Fields
Chip Music Festival - Magnetic Fields
Chords - Foundation
Chromagic - Dual Crew & Shining
Circle Scroller - United Forces
Clapping World - Subway
Coca Cola - Fraxion Demo
Coder Trash - Mexx
Color Crime - X-Trade
Colors - Devils
Coma - Rebels
Compact Music Disk 1 - Semtex
Compilation Disk - PowerLords
Concept Criminosical - Ruthless
Contravention - Reality
Copper master - Angels
Copper slave - Ram Jam
Crayon Shinchan - Melon Dezign
Crazy Sounds II - Team-X
Creamy Cranium 1 - Strangers
Crystal Symphonies - Phenomena
Crystal Symphonies 2 - Phenomena
Cutcreations - Static bytes
Cyber Sounds - Bastards