Demo - The Code Killers G.d.r. Intro
Dance Trance I - Interactive
Danish Know How - Flash Production
Darkroom - Stellar
Darktro - Darkness
Day of Reckoning - Digital
Deadly Jammin 2 - Deathstar
Decibel overload - Cue-X Developments
Deep Core - Balance
Deformations - Deform
Deja Vu - Anarchy
Delicate sounds - Razor 1911
Delirium - Fraxion
Delirium - Deform
Delirium - Fraxion
Demo Disk 1 - Apology
Demo-Disk - Quest
Demo Disk - Subway
Demons are forever - Doctor Mabuse Orgasm Crackings
Demon's Rage - Nerve Axis
Despair - LSD
Det kniber - Rebels
Diggy Piggys - Channel 42,The Silents
Digital Complexity - Crass
Digital concert 1 - Flash Production
Digital concert 2 - Flash Production
Digital concert 3 - Flash Production
Digital concert 4 - Flash Production
Digital Concert 5 - Flash Production
Digital concert 6 - Flash Production
Digital innovation - Anarchy
Digital Music Art - Wildfire
Digital Noises - Ram Jam
Digital sounds vol 1 - The Warfalcons
Disco Fever - Ipec Elite
Divine Inspiration - Goldfire
Dizzy Tunes 1 - Noiseless,The Silents
Don Martin - Hypnosis
D.O.S - Andromeda
Do the Bartman - Freehand
Double Intro Part1 - Vega Intro
Dream Trippin' - Digital
Drums & Reverbs - Chryseis
Dynamo - Orion