The 100 most remembered c64 game tunes - Sundell & Birk
The Amplifier 2 - Dimension4
The Audience is Listening - Taipan
The Beginning - Byterapers
The Best of Pearl - Byte Busters
The Complete - Talent
The drunk desert demo - Paradox Demo
The Fantastic Art Of Tobias Richter - Crusaders
The Hunt for 7th October - Cryptoburners
The enemies musics III - The Enemies
The Musique Disk - Accession
The Party II Slideshow - Decnite
The pink circle - Arcane
The Punisher - Digital
Thalion Sound demo - Thalion Demo
Tuneshow IV (Spherical Dreams) - The Acoustic Revolution
Technomania - Shining 8
Technomania 2 - Shining 8
Techno Trance - Bastards
Techno Trance 3 - Bastards
TechTech - Sodan,Magician 42
Tekkno Bert -The Final Collapse- - Wildfire
Tera Tunes - Alpha Flight
Tera Tunes II - Team-X
Terminal fuckup - Sanity
Testament - Katharsis
Third dimension - Cryptoburners
Titan Trax 1 - Titanics
Toxic Ziemniak - Alchemy
Trash - Digital
Trashcan - Wizzcat
Tropical sunset - The Silents
Tune Disk 1 - Concept
Tuneshow II - Prophets AG,The Acoustic Revolution
Tuneshow III - The Acoustic Revolution
Turmoil - Sanity
Turrican Musicdisk - Andromeda
Turrican Music-Show - Spreadpoint
Tympanic Membrane - Panacea
The Ultimate Gameboy Simulator - Tetris - Symbiosis
The Wall - Kefrens
The White Room - Genesis (AFL)